let a = () => {
  let ctx = context.ctx;
  let canvas = context.canvas;
  let yearly = context.yearly;
  let weekly = context.weekly;
  let monthly = context.monthly;
  let datax = context.datax;
  let lowest = context.lowest;
  let difference = context.difference;
  let maximum = context.maximum;
  let minimum = context.minimum;
  let list = context.list;
  let data = context.data;
  let datayx = context.datayx;
  let datayy = context.datayy;
  let datayh = context.datayh;
  let yorigintop = context.yorigintop;
  let yoriginbottom = context.yoriginbottom;
  let gradient1 = context.gradient1;
  let gradient = context.gradient;
  let wid = context.wid;
  let maxormin = context.maxormin;
  let maximumpossible = context.maximumpossible;
  let increment = context.increment;
  let divisor = context.divisor;
  let mark = context.mark;
  let scaley = context.scaley;
  let constantscaley = context.constantscaley;
  let precision = context.precision;
  let triwid = context.triwid;
  let gap = context.gap;
  let fgap = context.fgap;
  let bgap = context.bgap;
  let xoriginleft = context.xoriginleft;
  let xoriginright = context.xoriginright;
  let chartbeginx = context.chartbeginx;
  let constantleft = context.constantleft;
  let constantright = context.constantright;
  let constantbottom = context.constantbottom;
  let pathpoint = context.pathpoint;
  let chathi = context.chathi;
    let chatwi = context.chatwi;
        let dashy = context.dashy;
        let dashx = context.dashx;
      let begintexty = context.begintexty;
      let begintextx = context.begintextx;
  let fontguy = context.fontguy;
  let shadowx = context.shadowx;
  let shadowy = context.shadowy;
  let x = context.x;
  let y = context.y;
  let o = context.o;
  let state = context.state;
    let vgRoundRect= context.vgRoundRect
    let vgtextx= context.vgtextx
      let vgtexty= context.vgtexty
          let vglinex = context.vglinex;
              let vgliney = context.vgliney;
                let  vgchattri= context.vgchattri;
  let  vgchatrec= context.vgchatrec;
  let vgchattxt = context.vgchattxt;
};